"METIER_COD"	"METIER_LIB"
"GNSDGX"	"Filets maillants calés à Squales (divers)"
"GNSTUR"	"Filets maillants à turbot"
"GTRBSS"	"Trémails à Bar commun"
"GTRSBX"	"Trémails à sparidés"
"GTRMZZ"	"Trémails à poissons"
"GTR_GA"	"Trémails à Gadidés (divers)"
"GTRLCR"	"Trémails à grands crustacés"
"GTRVLO"	"Trémails à langoustes"
"GTRPOL"	"Trémails à lieu jaune"
"GTRMNZ"	"Trémails à baudroies"
"GTRMAX"	"Trémails à maquereaux"
"GTRHKX"	"Trémails à Merlus (divers)"
"GTRWHG"	"Trémails à merlan"
"GTRMUL"	"Trémails à mulets"
"GTRSWM"	"Trémails à petits crustacés"
"GTRFLX"	"Trémails à poissons plats"
"GTRRAJ"	"Trémails à raies"
"GTR_RE"	"Trémails à Murex, Rochers"
"GTRMUX"	"Trémails à rougets"
"GTRSCO"	"Trémails à rascasses"
"GTRCTL"	"Trémails à seiches, sépioles"
"GTRSOX"	"Trémails à soles"
"GTRDGX"	"Trémails à Squales (divers)"
"GTRTUR"	"Trémails à turbot"
"MSPPIQ"	"Epuisettes, Salabardes à crevette blanche"
"MSPMZZ"	"Epuisettes, Salabardes à poissons (divers)"
"INA"	"Inactif à la pêche"
"INE"	"Navire inexistant"
"LA_ANE"	"Lamparo à anchois"
"AUTLAM"	"Lamanage, pilotage"
"LHBSS"	"Lignes de traîne, Lignes à main à Bar commun"
"LHPCOE"	"Lignes et cannes manuelles à congre"
"LH_SBX"	"Lignes à main à sparidés"
"LH_MZZ"	"Lignes à main à poissons"
"LH_GA"	"Lignes de traîne, Lignes à main à Gadidés (divers)"
"LH_XOX"	"Lignes à main à lançons"
"LH_POL"	"Lignes à main à lieu jaune"
"LH_MAX"	"Lignes à main à maquereaux"
"LH_MUL"	"Lignes à main à mulets"
"LH_FLX"	"Lignes à main à poissons plats"
"LH_CTL"	"Lignes à main à seiches"
"LH_TUN"	"Lignes à main à thons"
"LLBSS"	"Palangres diverses (non spécifiées) à Bar commun"
"LL_SBX"	"Palangres diverses à sparidés"
"LL_MZZ"	"Palangres diverses à poissons"
"LL_MAX"	"Palangres diverses à maquereaux"
"LL_RAJ"	"Palangres diverses à raies"
"LLDSBX"	"Palangres dérivantes à sparidés"
"LLDMZZ"	"Palangres dérivantes à poissons"
"LLD_GA"	"Palangres dérivantes à Gadidés (divers)"
"LLDPOL"	"Palangres dérivantes à lieu jaune"
"LLDMAX"	"Palangres dérivantes à maquereaux"
"LLDHKX"	"Palangres dérivantes à Merlus (divers)"
"LLDDGX"	"Palangres dérivantes à Squales (divers)"
"LLDTUN"	"Palangres dérivantes à thons"
"LLSBSS"	"Palangres de fond (calées) à Bar commun"
"LLSCOE"	"Palangres à congre"
"LLSSBX"	"Palangres à sparidés"
"LLSMZZ"	"Palangres à poissons"
"LLS_GA"	"Palangres de fond (calées) à Gadidés (divers)"
"LLSPOL"	"Palangres à lieu jaune"
"LLSMAX"	"Palangres à maquereaux"
"LLSHKX"	"Palangres de fond (calées) à Merlus (divers)"
"LLSMGR"	"Palangres à maigre"
"LLSWHG"	"Palangres à merlan"
"LLSMUL"	"Palangres à mulets"
"LLSFLX"	"Palangres à poissons plats"
"LLSRAJ"	"Palangres à raies"
"LLSMUX"	"Palangres à rougets"
"LLSSOX"	"Palangres à soles"
"LLSDGX"	"Palangres de fond (calées) à Squales (divers)"
"LNSMZZ"	"Filets soulevés du rivage à poissons"
"LNSMUL"	"Filets soulevés du rivage à mulets"
"LNSFLX"	"Filets soulevés du rivage à poissons plats"
"LVDBSS"	"Palangres verticales dérivantes à Bar commun"
"LVSBSS"	"Palangres verticales de fond à Bar commun"
"MYT"	"Mytiliculture"
"AQUOST"	"Ostréiculture"
"OT_MZZ"	"Chaluts à panneaux (non spécifiés) à poissons (divers)"
"DRBVEV"	"Dragues à praire"
"SDVVEV"	"Plongée à praire"
"MHIKLK"	"Pêche à pied à vernis fauve"
"FPOLBA"	"Casiers à homard américain"
"FPOLBE"	"Casiers à homard"
"GTRLBE"	"Trémails à homard"
"FPOUPC"	"Casiers à langoustine sculptée"
"MHITWV"	"Pêche à pied à oursin blanc"
"DRBURC"	"Dragues remorquées par un bateau à Oursins nca"
"UNKMZZ"	"Métier de pêche inconnu ou non référencé"
"DRBCLX"	"Dragues remorquées par bateau à bivalves (divers)"
"SDVMUS"	"Plongée sous-marine à Moule commune"
"SDVMSM"	"Plongée sous-marine à Moule méditerranéenne"
"OTBELE"	"Chaluts de fond à anguille"
"OTBANE"	"Chaluts de fond à anchois"
"OTBBSS"	"Chaluts de fond à panneaux (1 Navire) à Bar commun"
"OTBCPR"	"Chaluts de fond à bouquet"
"OTBSQU"	"Chaluts de fond à calmars, encornets"
"OTBJAX"	"Chaluts de fond à chinchards"
"OTBIOD"	"Chaluts de fond à crabe nageur"
"OTBCSH"	"Chaluts de fond à crevette grise"
"OTBCET"	"Chaluts de fond à céteau"
"OTBSBX"	"Chaluts de fond à sparidés"
"OTBMZZ"	"Chaluts de fond à poissons"
"OTB_GA"	"Chaluts de fond à panneaux (1 Navire) à Gadidés (divers)"
"OTBGUX"	"Chaluts de fond à grondins"
"OTBDWS"	"Chaluts de fond à poissons de grands fonds"
"OTBHER"	"Chaluts de fond à hareng"
"OTBXOX"	"Chaluts de fond à lançons"
"OTBPOL"	"Chaluts de fond à lieu jaune"
"OTBNEP"	"Chaluts de fond à langoustine"
"OTBMNZ"	"Chaluts de fond à baudroies"
"OTBPOK"	"Chaluts de fond à lieu noir"
"OTBMAX"	"Chaluts de fond à maquereaux"
"OTBHKX"	"Chaluts de fond à panneaux (1 Navire) à Merlus (divers)"
"OTBMGR"	"Chaluts de fond à maigre"
"OTBWHG"	"Chaluts de fond à merlan"
"OTBMUL"	"Chaluts de fond à mulets"
"OTBFLX"	"Chaluts de fond à poissons plats"
"OTBRAJ"	"Chaluts de fond à raies"
"OTBMUX"	"Chaluts de fond à rougets"
"OTBCTL"	"Chaluts de fond à seiches"
"OTBSOX"	"Chaluts de fond à soles"
"OTBDGX"	"Chaluts de fond à panneaux (1 Navire) à Squales (divers)"
"OTBQSC"	"Chaluts de fond à pétoncle blanc (vanneau)"
"OTMANE"	"Chaluts pélagiques à anchois"
"OTMBSS"	"Chaluts pélagiques à panneaux (1 Navire) à Bar commun"
"OTMSQU"	"Chaluts pélagiques à calmars, encornets"
"OTMJAX"	"Chaluts pélagiques à chinchards"
"OTMSBX"	"Chaluts pélagiques à sparidés"
"OTMMZZ"	"Chaluts pélagiques à poissons"
"OTM_GA"	"Chaluts pélagiques à panneaux (1 Navire) à Gadidés (divers)"
"OTMHER"	"Chaluts pélagiques à hareng"
"OTMPOL"	"Chaluts pélagiques à lieu jaune"
"OTMMAX"	"Chaluts pélagiques à maquereaux"
"OTMHKX"	"Chaluts pélagiques à panneaux (1 Navire) à Merlus (divers)"
"OTMWHG"	"Chaluts pélagiques à merlan"
"OTMMUL"	"Chaluts pélagiques à mulets"
"OTMPIL"	"Chaluts pélagiques à sardine"
"OTMTUN"	"Chaluts pélagiques à thons"
"SDV_CJ"	"Plongée avec bouteilles à coquilles Saint Jacques"
"SDVHLT"	"Plongée à ormeau"
"SDVINV"	"Plongée à invertébrés aquatiques"
"SDVCOR"	"Plongée sous-marine à Coraux"
"SDVDON"	"Plongée à donax (tellines)"
"SDVSWX"	"Plongée à algues"
"SDVMSX"	"Plongée sous-marine à Moules (divers)"
"SDVECH"	"Plongée sous-marine à Oursins, Echinodermes"
"SDV_PA"	"Plongée sous-marine à palourdes"
"SDVSSG"	"Plongée à violet"
"MHICOC"	"Pêche à pied à coque"
"MHIPEE"	"Pêche à pied à bigorneau"
"MHISWX"	"Pêche à pied à algues"
"MHIMSX"	"Pêche à pied à Moules (divers)"
"MHIECH"	"Pêche à pied à Oursins, Echinodermes"
"MHI_PA"	"Pêche à pied à palourdes"
"MHIPCB"	"Pêche à pied à pouce-pied"
"MHIWOR"	"Pêche à pied à vers marins"
"PREBSS"	"Charter de pêche de loisir à Bar commun"
"PREMZZ"	"Charter de pêche de loisir à poissons"
"PREMAX"	"Charter de pêche de loisir à maquereaux"
"AUTPRM"	"Promenade en mer"
"PS_ANE"	"Sennes coulissantes à anchois"
"PSBSS"	"Sennes tournantes coulissantes à Bar commun"
"PS_JAX"	"Sennes coulissantes à chinchards"
"PS_SBX"	"Sennes coulissantes à sparidés"
"PS_MZZ"	"Sennes coulissantes à poissons"
"PS_HER"	"Sennes coulissantes à hareng"
"PS_MAX"	"Sennes coulissantes à maquereaux"
"PS_MUL"	"Sennes coulissantes à mulets"
"PS_PIL"	"Sennes coulissantes à sardine"
"PS_TUN"	"Sennes coulissantes à thons"
"PT_MZZ"	"Divers chaluts b½ufs à poissons (divers)"
"PTBBSS"	"Chaluts boeufs de fond (2 Navires) à Bar commun"
"PTBSQU"	"Chaluts boeufs de fond à calmars, encornets"
"PTBSBX"	"Chaluts boeufs de fond à sparidés"
"PTBMZZ"	"Chaluts boeufs de fond à poissons"
"PTB_GA"	"Chaluts boeufs de fond (2 Navires) à Gadidés (divers)"
"PTBNEP"	"Chaluts boeufs de fond à langoustine"
"PTBMNZ"	"Chaluts boeufs de fond à baudroies"
"PTBHKX"	"Chaluts boeufs de fond (2 Navires) à Merlus (divers)"
"PTBWHG"	"Chaluts boeufs de fond à merlan"
"PTBFLX"	"Chaluts boeufs de fond à poissons plats"
"PTBCTL"	"Chaluts boeufs de fond à seiches"
"PTBSOX"	"Chaluts boeufs de fond à soles"
"PTMANE"	"Chaluts boeufs pélagiques à anchois"
"PTMBSS"	"Chaluts boeufs pélagiques (2 Navires) à Bar commun"
"PTMSQU"	"Chaluts boeufs pélagiques à calmars, encornets  "
"PTMJAX"	"Chaluts boeufs pélagiques à chinchards"
"PTMSBX"	"Chaluts boeufs pélagiques à sparidés"
"PTMMZZ"	"Chaluts boeufs pélagiques à poissons"
"PTMHER"	"Chaluts boeufs pélagiques à hareng"
"PTMPOL"	"Chaluts boeufs pélagiques à lieu jaune"
"PTMMAX"	"Chaluts boeufs pélagiques à maquereaux"
"PTMHKX"	"Chaluts boeufs pélagiques (2 Navires) à Merlus (divers)"
"PTMWHG"	"Chaluts boeufs pélagiques à merlan"
"PTMMUL"	"Chaluts boeufs pélagiques à mulets"
"PTMPIL"	"Chaluts boeufs pélagiques à sardine"
"PTMTUN"	"Chaluts boeufs pélagiques à thons"
"SB_MZZ"	"Sennes de plage à poissons"
"HMSSWX"	"Scoubidou à laminaire"
"SV_XOX"	"Sennes halées à bord à lançons"
"GESEL1"	"Tamis à civelle"
"TBBSQU"	"Chaluts à perche à calmars, encornets"
"TBBCSH"	"Chaluts à perche à crevette grise"
"TBBMZZ"	"Chaluts à perche à poissons"
"TBB_GA"	"Chaluts à perche à Gadidés (divers)"
"TBBFLX"	"Chaluts à perche à poissons plats"
"TBBSCO"	"Chaluts à perche à rascasses"
"TBBCTL"	"Chaluts à perche à seiches"
"TBBSOX"	"Chaluts à perche à soles"
"AUTSWX"	"Transport d'algues"
"OTTSQU"	"Chaluts jumeaux à calmars, encornets"
"OTTMZZ"	"Chaluts jumeaux à poissons"
"OTT_GA"	"Chaluts jumeaux à Gadidés (divers)"
"OTTDWS"	"Chaluts jumeaux à poissons de grands fonds"
"OTTNEP"	"Chaluts jumeaux à langoustine"
"OTTMNZ"	"Chaluts jumeaux à baudroies"
"OTTHKX"	"Chaluts jumeaux à Merlus (divers)"
"OTTFLX"	"Chaluts jumeaux à poissons plats"
"OTTRAJ"	"Chaluts jumeaux à raies"
"OTTMUX"	"Chaluts jumeaux à rougets"
"OTTCTL"	"Chaluts jumeaux à seiches"
"OTTSOX"	"Chaluts jumeaux à soles"
"OTTQSC"	"Chaluts jumeaux à panneaux à pétoncle blanc ou vanneau"
"VEN"	"Vénériculture"
"LNBMZZ"	"Filets soulevés d'un bateau à poissons"
"OTB_EP"	"Chaluts de fond à panneaux (1 Navire) à Eperlans (divers)"
"FPOLAU"	"Casiers à lamproie"
"AQUSWX"	"Algoculture"
"FDVSWX"	"Apnée à algues"
"DRBCOC"	"Dragues à coque"
"DRBINV"	"Dragues à invertébrés"
"FPOCZM"	"Casiers à bernard l'ermite  "
"FPOARA"	"Nasses (casiers non spécifiés) à crevette rouge"
"FPOMZZ"	"Nasses à poissons"
"FPO_GI"	"Casiers à girelles"
"FWRMZZ"	"Barrages, Parcs, Bordigues à poissons"
"FWRSBG"	"Barrages, Parcs, Bordigues à dorade royale"
"TMBMZZ"	"Grands ganguis à armature à poissons"
"GNCSIL"	"Filets maillants encerclants à athérines (divers)"
"GNCMZZ"	"Filets maillants encerclants à poissons"
"GNCSBG"	"Filets maillants encerclants à dorade royale"
"GNCMUL"	"Filets maillants encerclants à mulets"
"GNDBZX"	"Filets maillants dérivants à bonites"
"GNDPIL"	"Filets maillants dérivants à sardine"
"GNDBFT"	"Filets maillants dérivants à thon rouge"
"GNEBSS"	"Filets flottants (maillants calés) à Bar commun"
"GNSBZX"	"Filets maillants à bonites"
"GNSSBG"	"Filets maillants à dorade royale"
"GNSVLO"	"Filets maillants à langoustes"
"GNSLAU"	"Filets maillants à lamproie marine"
"GNSPIL"	"Filets maillants à sardine"
"GNSBFT"	"Filets maillants  à thon rouge"
"GTNBSS"	"Trémails et filets maillants combinés à Bar commun"
"GTNBZX"	"Trémails et filets maillants à bonites"
"GTNSBX"	"Trémails et filets maillants à sparidés"
"GTNMZZ"	"Trémails et filets maillants à poissons"
"GTNSBG"	"Trémails et filets maillants à dorade royale"
"GTNSCO"	"Trémails et filets maillants à rascasses"
"GTRLOS"	"Trémails à cigales"
"GTRSBG"	"Trémails à dorade royale"
"GTRLBS"	"Trémails à Homards (divers)"
"GTRMGR"	"Trémails à maigre"
"MSPCPR"	"Epuisettes, Salabardes à crevette bouquet ou bouquet commun"
"MPNCSH"	"Pousseux, Troubles à crevette grise"
"MSPPIL"	"Epuisettes, Salabardes à sardine commune"
"LH_BZX"	"Lignes à main à bonites"
"LH_SBR"	"Lignes à main à dorade rose"
"LH_OCT"	"Lignes à main à poulpes"
"LH_BFT"	"Lignes à main à thon rouge"
"LHMBSS"	"Lignes et lignes avec cannes mécanisées à Bar commun"
"LHMMZZ"	"Lignes à main et à cannes mécanisées à poissons"
"LHPBSS"	"Lignes à main et lignes avec cannes à Bar commun"
"LHPMZZ"	"Lignes et cannes manuelles à poissons"
"LHPMAX"	"Lignes et cannes manuelles à maquereaux"
"LHPOCT"	"Lignes et cannes manuelles à poulpes"
"LHPJOD"	"Lignes et cannes manuelles à Saint-Pierre"
"LLDBSS"	"Palangres dérivantes à Bar commun"
"LLDBRZ"	"Palangres dérivantes à castagnoles (divers)"
"LLDSWO"	"Palangres dérivantes à espadon"
"LLDBFT"	"Palangres dérivantes à thon rouge"
"LLFBSS"	"Palangres calées flottantes à Bar commun"
"LLFSBG"	"Palangres flottantes à dorade royale"
"LLSELE"	"Palangres  à anguille"
"LLSSBR"	"Palangres de fond à dorade rose"
"LLSSBG"	"Palangres à dorade royale"
"LLSCUT"	"Palangres à sabres  "
"LNBMUL"	"Filets soulevés du bateau à mulets"
"LNBFLX"	"Filets soulevés du bateau à poissons plats"
"LNSELE"	"Filets soulevés du rivage à anguille"
"LSPBSS"	"Lignes calées (avec ou sans canne) à Bar commun"
"LTLBSS"	"Lignes de traîne à Bar commun"
"LTLBZX"	"Lignes de traîne à bonites"
"LTLMZZ"	"Lignes de traîne à poissons"
"LTLSWO"	"Lignes de traîne à espadons"
"LTLMAX"	"Lignes de traîne à maquereaux"
"LTLBFT"	"Lignes de traîne à thon rouge"
"OTBSBG"	"Chaluts de fond à dorade royale"
"OTBOST"	"Chaluts de fond à huîtres"
"SDVMZZ"	"Plongée à poissons"
"SDV_PR"	"Plongée sous-marine à praires"
"MHIRAZ"	"Pêche à pied à couteaux"
"MHIINV"	"Pêche à pied à invertébrés"
"MHIOST"	"Pêche à pied à huîtres"
"MHI_SL"	"Pêche à pied à salicorne"
"PREBFT"	"Charter de pêche de loisir à thon rouge"
"PS_BFT"	"Sennes coulissantes à thon rouge"
"SB_RE"	"Sennes de plage à Murex, Rochers"
"SB_PIL"	"Sennes de plage à sardine"
"SV_MZZ"	"Sennes halées à bord à poissons"
"TBB_CJ"	"Chaluts à perche à coquilles Saint Jacques"
"GNSCOD"	"Filets maillants à morue"
"OTTCSH"	"Chaluts jumeaux à crevette grise"
"FPO_CV"	"Nasses/Casiers à Crabes verts (divers)"
"FPOLIO"	"Casiers à étrille"
"OTGZZZ"	"Engins traînants à divers espèces"
"OFGZZZ"	"Engins dormants à divers"
"OFGMSH"	"Engins dormants à coquillages (divers)"
"OFGDCP"	"Engins dormants à crevettes (divers)"
"OFGMZZ"	"Engins dormants à poissons (divers)"
"OFGDIA"	"Engins dormants à saumon, truite, aloses (divers)"
"OTGDIA"	"Engins traînants à saumon, truite, aloses (divers)"
"OTGDCP"	"Engins traînants à crevettes (divers)"
"LNB_EP"	"Filets soulevés manoeuvrés du bateau à Eperlans (divers)"
"HMSHLZ"	"Scoubidou à himanthale"
"MHIASN"	"Pêche à pied à goëmon"
"FPOIYL"	"Nasses (casiers non spécifiés) à bichique (alevin de cabot)"
"FPODCP"	"Casiers à crevettes"
"FPONAS"	"Casiers à poisson licorne"
"GNSPWT"	"Filets maillants à perroquets"
"LHPSQU"	"Lignes et cannes manuelles à calmars, encornets"
"LHJTUN"	"Jigs à thons"
"LHPLPF"	"Lignes et cannes manuelless à grands pélagiques"
"LHPSPF"	"Lignes et cannes manuelles à petits pélagiques"
"LHMSQU"	"Lignes à main et à cannes mécanisées à calmars, encornets"
"LLSTOP"	"Palangres calées (fixes) à légine australe"
"LLSEBS"	"Palangres à mochong"
"LLS_MS"	"Palangres à mérous"
"LLSUSB"	"Palangres à vieille commune"
"LLSSNX"	"Palangres à vivaneaux"
"LNPRAQ"	"Filets soulevés portatifs à crabe girafe"
"LTLLPF"	"Lignes de traîne à grands pélagiques"
"LTLSPF"	"Lignes de traîne à petits pélagiques"
"LVDDOX"	"Palangres verticales dérivantes à dorades coryphènes"
"LVDLPF"	"Palangres verticales dérivantes à grands pélagiques"
"AUTAFP"	"Affrètement commercial"
"FDVHLT"	"Apnée à ormeau"
"FDVINV"	"Apnée à invertébrés"
"FDV_EC"	"Apnée à éponges, coraux"
"FDVDON"	"Apnée à donax (tellines)"
"FDVLCR"	"Apnée à grands crustacés  "
"FDVMSX"	"Apnée à Moules (divers)"
"FDVECH"	"Apnée à Oursins, Echinodermes"
"FDV_PA"	"Apnée à palourdes"
"FDV_RE"	"Apnée à Murex, Rochers"
"FDVSSG"	"Apnée à violet"
"AQUBSS"	"Aquaculture à Bar commun"
"AQUSBX"	"Aquaculture à sparidés"
"AQUMZZ"	"Aquaculture à poissons  "
"AQUSLZ"	"Aquaculture à salmonidés"
"FAGELE"	"Balais, Fagots à anguille"
"FAGCPR"	"Balais, Fagots à bouquet"
"AQUCLX"	"Conchyliculture"
"CON_PA"	"Conchyliculture de palourdes"
"AUTDEP"	"Dépollution"
"DRBGKL"	"Dragues à amande de mer"
"DRBPIQ"	"Dragues à crevette blanche"
"DRB_CJ"	"Dragues remorquées par un bateau à coquilles Saint Jacques"
"DRBMSH"	"Dragues remorquées par bateau à coquillages (divers)"
"DRBSWX"	"Dragues à algues"
"DRBOST"	"Dragues à huîtres"
"DRBXOX"	"Dragues à lançons"
"DRBMSX"	"Dragues remorquées par un bateau à Moules (divers)"
"DRBECH"	"Dragues remorquées par un bateau à Oursins, Echinodermes"
"DRB_PA"	"Dragues remorquées par un bateau à  palourdes"
"DRBVSC"	"Dragues à pétoncle noir"
"DRBFLX"	"Dragues à poissons plats"
"DRB_PR"	"Dragues remorquées par un bateau à praires"
"DRB_RE"	"Dragues remorquées par un bateau à Murex, Rochers"
"DRBMAT"	"Dragues à mactres, spisules"
"DRBSOX"	"Dragues à soles"
"DRBQSC"	"Dragues à pétoncle blanc (vanneau)"
"DHBMSX"	"Dragues à main embarquées à Moules (divers)"
"DHB_PA"	"Dragues à main embarquées à palourdes"
"DHSDON"	"Dragues à main de rivage à tellines"
"AUTEXT"	"Extraction d'eau ou de granulats"
"FPOELE"	"Casiers à anguille"
"FPOPIQ"	"Casiers à crevette blanche"
"FPOCPR"	"Casiers à bouquet"
"FPOWHE"	"Casiers à buccin"
"FPOIOD"	"Casiers à crabe nageur"
"FPOCOE"	"Casiers à congre"
"FPOLCR"	"Casiers à grands crustacés"
"FPOLBS"	"Nasses/Casiers à Homards (divers)"
"FPOVLO"	"Casiers à langoustes "
"FPONEP"	"Casiers à langoustine"
"FPOOCT"	"Casiers à poulpes"
"FPOCTL"	"Casiers à seiches"
"FYKELE"	"Verveux à anguille"
"FYKCOE"	"Verveux à congre"
"FYKMZZ"	"Verveux à poissons"
"GENSBX"	"Filets maillants et emmêlants à sparidés"
"GENMZZ"	"Filets maillants et emmêlants à poissons"
"GENMNZ"	"Filets maillants et emmêlants à baudroies"
"GN_MZZ"	"Filets maillants à poissons"
"GNCBSS"	"Filets maillants encerclants à Bar commun"
"GNCSBX"	"Filets maillants encerclants à sparidés"
"GNCMAX"	"Filets maillants encerclants à maquereaux"
"GNDBSS"	"Filets maillants dérivants à Bar commun"
"GNDMZZ"	"Filets maillants dérivants à poissons"
"GND_GA"	"Filets maillants dérivants à Gadidés (divers)"
"GNDHER"	"Filets maillants dérivants à hareng"
"GNDPOL"	"Filets maillants dérivants à lieu jaune"
"GNDLAU"	"Filets maillants dérivants à lamproie"
"GNDMAX"	"Filets maillants dérivants à maquereaux"
"GNDHKX"	"Filets maillants dérivants à Merlus (divers)"
"GNDMGR"	"Filets maillants dérivants à maigre"
"GNDWHG"	"Filets maillants dérivants à merlan"
"GNDMUL"	"Filets maillants dérivants à mulets"
"GNDMUX"	"Filets maillants dérivants à rougets"
"GNDDGX"	"Filets maillants dérivants à Squales (divers)"
"GNDTUN"	"Filets maillants dérivants à thons"
"GNSBSS"	"Filets maillants calés à Bar commun"
"GNSSQU"	"Filets maillants à calmars, encornets"
"GNSSBX"	"Filets maillants à sparidés"
"GNSMZZ"	"Filets maillants à poissons"
"GNS_GA"	"Filets maillants calés à Gadidés (divers)"
"GNSLCR"	"Filets maillants à grands crustacés"
"GNSPOL"	"Filets maillants à lieu jaune"
"GNSMNZ"	"Filets maillants à baudroies"
"GNSMAX"	"Filets maillants à maquereaux"
"GNSHKX"	"Filets maillants calés à Merlus (divers)"
"GNSMGR"	"Filets maillants à maigre"
"GNSWHG"	"Filets maillants à merlan"
"GNSMUL"	"Filets maillants à mulets"
"GNSSWM"	"Filets maillants câlés à petits crustacés"
"GNSFLX"	"Filets maillants à poissons plats"
"GNSRAJ"	"Filets maillants à raies"
"GNSMUX"	"Filets maillants à rougets"
"GNSCTL"	"Filets maillants à seiches"
"GNSSOX"	"Filets maillants à soles"
"LHPBIS"	"Lignes et cannes manuelles à sélar coulisou"
"LX_LPF"	"Palangres et lignes à grands pélagiques"
"PSBEN"	"Sennes tournantes coulissantes à Orphies, Aiguilles"
"LLDLPF"	"Palangres dérivantes à grands pélagiques"
"PS_SPF"	"Sennes coulissantes à petits pélagiques"
"MHICON"	"Pêche à pied à lambis"
"MHIMZZ"	"Pêche à pied à poissons"
"MHITDG"	"Pêche à pied à bénitier"
"FPOCRG"	"Nasses/Casiers à Crabe vert"
"GNCSSB"	"Filets maillants encerclants à marbré"
"GNESBG"	"Filets maillants flottants à dorade royale"
"GNSSSB"	"Filets maillants à marbré"
"GNSSWA"	"Filets maillants calés à Sar commun"
"GTRSSB"	"Trémails à marbré"
"LHPYFT"	"Lignes et cannes manuelles à albacore"
"LTLYFT"	"Lignes de traîne à albacore"
"SV_SPF"	"Sennes halées à bord à petits pélagiques"
"OTMWHB"	"Chaluts pélagiques à panneaux à merlan bleu"
"GNESHZ"	"Filets maillants flottants à aloses"
"FDVLPF"	"Apnée à grands pélagiques (divers)"
"GTRLAU"	"Trémails à lamproie"
"AQUMYV"	"Mytiliculture"
"LLSJOD"	"Palangres à Saint-Pierre"
"FSNDCP"	"Filets à l'étalage (diables) à crevettes"
"LHPEET"	"Lignes et cannes manuelles à mérou géant"
"LLSEET"	"Palangres à mérou géant"
"FPOCAL"	"Casiers à crabes Callinectes"
"GNSMSD"	"Filets maillants à comète maquereau"
"LLSDG2"	"Palangres de fond (calées) à Requins"
"LTLTUN"	"Lignes de traîne à thons"
"SB_TUN"	"Sennes de plage à thons"
"FDVTWV"	"Apnée à oursin blanc"
"GNSMUM"	"Filets maillants à rougets et poissons chèvres"
"MHIKDG"	"Pêche à pied à crabe de terre"
"MISMZZ"	"Divers engins à poissons (divers)"
"GTRBAI"	"Trémails à poissons batoïdes"
"GNSBAI"	"Filets maillants à poissons batoïdes ou rajiformes"
"SPRMZZ"	"Sennes boeufs à poissons"
"SDNMAX"	"Sennes danoises à maquereaux"
"SDNWHG"	"Sennes danoises à merlan"
"SDNBSE"	"Sennes danoises à bars"
"MHIMSM"	"Pêche à pied à Moule méditerranéenne"
"SDVOYF"	"Plongée à huître plate"
"SDVOYG"	"Plongée sous-marine à Huîtres creuses"
"FDVOYG"	"Apnée à Huîtres creuses"
"FDVOYF"	"Apnée à huître plate"
"MHIOYF"	"Pêche à pied à huître plate"
"MHIOYG"	"Pêche à pied à Huîtres creuses"
"OTBOYF"	"Chaluts de fond à huître plate"
"OTBOYG"	"Chaluts de fond à panneaux (1 Navire) à Huîtres creuses"
"LTLBLF"	"Lignes de traîne à thon à nageoires noires"
"GTRDEC"	"Trémails à denté"
"LLFSBX"	"Palangres flottantes à sparidés"
"LLSBSH"	"Palangres à peau bleue"
"LLFMZZ"	"Palangres flottantes à poissons"
"MHIUCC"	"Pêche à pied à crabe mantou"
"FDVMSM"	"Apnée à Moule méditerranéenne"
"FDVMUS"	"Apnée à Moule commune (atlantique)"
"DRBKLK"	"Dragues à vernis"
"DRBUR1"	"Dragues remorquées par un bateau à Oursin vert"
"LVDBIL"	"Palangres verticales dérivantes à marlins, makaires, voiliers"
"LVDTUN"	"Palangres verticales dérivantes à thons"
"MHIOCT"	"Pêche à pied à poulpes"
"PRELPF"	"Charter de pêche de loisir à grands pélagiques"
"SB_SPF"	"Sennes de plage à petits pélagiques"
"SB_MUV"	"Sennes de plage à capucins à bande jaune"
"SB_IYL"	"Sennes de plage à bichique"
"TBSDCP"	"Chaluts de fond floridien à crevettes"
"FSNMZZ"	"Filets à l'étalage (diables) à poissons"
"LHP_MS"	"Lignes et cannes manuelles à mérous"
"GNSJOD"	"Filets maillants à saint-Pierre"
"MHILPZ"	"Pêche à pied à patelles"
"FSNELE"	"Filets à l'étalage (diables) à anguille"
"FSNSBG"	"Filets à l'étalage (diables) à dorade royale"
"DHBWOR"	"Dragues à main embarquées à vers marins"
"SDVOST"	"Plongée à huîtres"
"PTMBFT"	"Chaluts boeufs pélagiques à thon rouge"
"GNEMUL"	"Filets maillants flottants à mulets"
"GNS_EP"	"Filets maillants calés à Eperlans (divers)"
"FPOCRQ"	"Casiers à crabe des neiges"
"FPOMYG"	"Casiers à myxine"
"DRBCUX"	"Dragues à concombres de mer"
"GNSLUM"	"Filets maillants câlés à lompe"
"GNSSAL"	"Filets maillants à saumon de l'Atlantique"
"MSPCAP"	"Epuisettes, Salabardes à capelan"
"SB_CAP"	"Sennes de plage à capelan"
"OTBCOD"	"Chaluts de fond à morue"
"LHPCOD"	"Lignes et cannes manuelles à morue"
"OTBDCP"	"Chaluts de fond à crevettes"
"AUTMZZ"	"Transport de poissons"
"FDVMZZ"	"Apnée à poissons"
"FDVCON"	"Apnée à lambis"
"FDVVLO"	"Apnée à langoustes"
"PS_LPF"	"Sennes coulissantes à grands pélagiques"
"DRBCON"	"Dragues à lambis"
"FCNMZZ"	"Eperviers à poissons"
"FPOMUI"	"Casiers à murènes"
"FPOSNX"	"Nasses à vivaneaux"
"GNCHAX"	"Filets maillants encerclants à demi-becs"
"GNCBIS"	"Filets maillants encerclants à sélar coulisou"
"GNCBEN"	"Filets maillants encerclants à aiguilles, orphies"
"GNCCLU"	"Filets maillants encerclants à sardinelles, harengules"
"GNDHAX"	"Filets maillants dérivants à demi-becs"
"GNDFLY"	"Filets maillants dérivants à poissons volants"
"GNSCGX"	"Filets maillants à carangidés"
"GNSCON"	"Filets maillants à lambis"
"GNSBLF"	"Filets maillants à thon à nageoires noires"
"GNSSNX"	"Filets maillants à vivaneaux"
"MSPFLY"	"Epuisettes, Salabardes à poissons volants ou exocets (divers)"
"LHPDOX"	"Lignes et cannes manuelles à dorades coryphènes"
"LHPBIL"	"Lignes et cannes manuelles à marlins, makaires, voiliers"
"LHPBEN"	"Lignes et cannes manuelles à aiguilles, orphies"
"LHPDEF"	"Lignes et cannes manuelles à poissons démersaux"
"LHPSNY"	"Lignes et cannes manuelles à vivaneau à queue jaune"
"LHPSNX"	"Lignes et cannes manuelles à vivaneaux"
"LLSDEF"	"Palangres à poissons démersaux"
"LLSSNY"	"Palangres à vivaneau à queue jaune"
"LTF_LP"	"Lignes de traîne de fond à grands pélagiques"
"LTLKGX"	"Lignes de traîne à thazards"
"LTP_LP"	"Lignes de traîne profonde à grands pélagiques"
"LTS_LP"	"Lignes de traîne de surface à grands pélagiques"
"GNDLPF"	"Filets maillants dérivants à grands pélagiques"
"MHIRSQ"	"Pêche à pied à crabe cirique"
"MHIEWX"	"Pêche à pied à soudons"
"PS_BZX"	"Sennes coulissantes à bonites"
"PS_SNY"	"Sennes coulissantes à vivaneau à queue jaune"
"SB_HAX"	"Sennes de plage à demi-becs"
"SB_BZX"	"Sennes de plage à bonites"
"SB_BIS"	"Sennes de plage à sélar coulisou"
"SB_BEN"	"Sennes de plage à aiguilles, orphies"
"SB_SNY"	"Sennes de plage à vivaneau à queue jaune"
"FPOUSB"	"Nasses à vieille"
"LLSCOD"	"Palangres à morue"
"FDVKUI"	"Apnée à troque"
"AUTPAS"	"Transport de passagers"
"FDVOST"	"Apnée à huîtres"
"LHPBZX"	"Lignes et cannes manuelles à bonites"
"LHPSBX"	"Lignes et cannes manuelles à sparidés"
"LHPSBR"	"Lignes et cannes manuelles à dorade rose"
"LHP_GA"	"Lignes à main et lignes avec cannes à Gadidés (divers)"
"LHPXOX"	"Lignes et cannes manuelles à lançons"
"LHPPOL"	"Lignes et cannes manuelles à lieu jaune"
"LHPMUL"	"Lignes et cannes manuelles à mulets"
"LHPFLX"	"Lignes et cannes manuelles à poissons plats"
"LHPCTL"	"Lignes et cannes manuelles à seiches"
"LHPTUN"	"Lignes et cannes manuelles à thons"
"LHPBFT"	"Lignes et cannes manuelles à thon rouge"
"LHMPOL"	"Lignes à main et à cannes mécanisées à lieu jaune"
"LTLPOL"	"Lignes de traîne à lieu jaune"
"GNDSBX"	"Filets maillants dérivants à sparidés"
"FPORSQ"	"Casiers à crabe cirique"
"OTTCET"	"Chaluts jumeaux à panneaux à céteau"
"TBBQSC"	"Chaluts à perche à pétoncle blanc (vanneau)"
"SDNSQU"	"Sennes danoises à calmars, encornets"
"SDNCOD"	"Sennes danoises à morue"
"SDNMUX"	"Sennes danoises à rougets"
"GTRCON"	"Trémails à lambis"
"AUTHER"	"Hersage de crépidules, draguage d'étoiles de mer (divers)"
"LHMDEF"	"Lignes à main et à cannes mécanisées à poissons démersaux"
"SDNMZZ"	"Sennes danoises à poissons"
"OTBJOD"	"Chaluts de fond à Saint-Pierre"
"OTTCOD"	"Chaluts jumeaux à morue"
"PS_SBG"	"Sennes coulissantes à dorade royale"
"GTRCOD"	"Trémails à morue"
"OTBSHZ"	"Chaluts de fond à aloses"
"OTMSHZ"	"Chaluts pélagiques à aloses"
"GNDSHZ"	"Filets maillants dérivants à aloses"
"GNSSHZ"	"Filets maillants à aloses"
"GNSANG"	"Filets maillants à baudroie d'Amérique"
"OTBHKS"	"Chaluts de fond à panneaux à merlu argenté"
"PTBHKE"	"Chaluts boeufs de fond à merlus"
"OTBHKE"	"Chaluts de fond à merlu"
"OTTHKE"	"Chaluts jumeaux à merlu"
"PTMHKE"	"Chaluts boeufs pélagiques à merlu"
"OTMHKE"	"Chaluts pélagiques à merlu"
"GNDHKE"	"Filets maillants dérivants à merlu"
"GNSHKE"	"Filets maillants à merlu"
"LLSHKE"	"Palangres à merlu"
"LLDHKE"	"Palangres dérivantes à merlu"
"GTRHKE"	"Trémails à merlu"
"OTBSLZ"	"Chaluts de fond à salmonidés"
"OTMSLZ"	"Chaluts pélagiques à salmonidés"
"GNDSLZ"	"Filets maillants dérivants à salmonidés"
"GNSSLZ"	"Filets maillants à salmonidés"
"PTMALB"	"Chaluts boeufs pélagiques à thon germon"
"OTMALB"	"Chaluts pélagiques à thon germon"
"GNDALB"	"Filets maillants dérivants à thon germon"
"GNSALB"	"Filets maillants  à thon germon"
"LH_ALB"	"Lignes à main à thon germon"
"LHPALB"	"Lignes et cannes manuelles à thon germon"
"LLDALB"	"Palangres dérivantes à thon germon"
"LVDALB"	"Palangres verticales dérivantes à thon germon"
"PS_ALB"	"Sennes coulissantes à thon germon"
"TBBSCE"	"Chaluts à perche à coquille St-Jacques"
"DRBSCE"	"Dragues à coquille St-Jacques"
"SDVSCE"	"Plongée à coquille St-Jacques de l'Atlantique"
"TBBSJA"	"Chaluts à perche à coquille St-Jacques de Méditerranée"
"DRBSJA"	"Dragues à coquille St-Jacques de Méditerranée"
"DRBISC"	"Dragues à pétoncle d'Islande"
"TBBSCA"	"Chaluts à perche à pétoncle géant d'Amérique"
"DRBSCA"	"Dragues à pétoncle géant d'Amérique"
"TBBVSC"	"Chaluts à perche à pétoncle noir"
"OTBVSC"	"Chaluts de fond à pétoncle noir"
"OTTVSC"	"Chaluts jumeaux à panneaux à pétoncle noir"
"DRBOYG"	"Dragues remorquées par un bateau à Huître creuse"
"DRBOYF"	"Dragues à huître plate"
"DHBMUS"	"Dragues à main embarquées à Moule commune"
"DRBMUS"	"Dragues remorquées par un bateau à Moule commune"
"MHIMUS"	"Pêche à pied à Moule commune"
"DHBMSM"	"Dragues à main embarquées à Moule méditerranéenne"
"DRBMSM"	"Dragues remorquées par un bateau à Moule méditerranéenne"
"DRBVNR"	"Dragues à palourde rose"
"FDVTPS"	"Apnée à palourdes"
"DHBTPS"	"Dragues à main embarquées à palourdes"
"DRBTPS"	"Dragues à palourdes"
"MHITPS"	"Pêche à pied à palourdes"
"SDVTPS"	"Plongée à palourdes"
"DRBKFA"	"Dragues à praire chambrière"
"OTBBLI"	"Chaluts de fond à lingue bleue"
"OTMMGR"	"Chaluts pélagiques à maigre"
"PTMMGR"	"Chaluts boeufs pélagiques à maigre"
"LHJMZZ"	"Jigs à poissons"
"SV_BEN"	"Sennes halées à bord à aiguilles, orphies"
"AQUBSE"	"Aquaculture à bars"
"AQUTPS"	"Vénériculture"
"DHBMYV"	"Dragues à main embarquées à moules"
"DRBJLX"	"Dragues à murex"
"DRBMYV"	"Dragues à moules"
"DRBURX"	"Dragues à oursins"
"FDVJLX"	"Apnée à murex"
"FDVMYV"	"Apnée à moules"
"FDVURX"	"Apnée à oursins"
"MHIMYV"	"Pêche à pied à moules"
"MHIURX"	"Pêche à pied à oursins"
"FPOCZW"	"Casiers à crabes verts"
"GNCBSE"	"Filets maillants encerclants à bars"
"GNCSMX"	"Filets maillants encerclants à éperlans"
"GNDBSE"	"Filets maillants dérivants à bars"
"GNDGAD"	"Filets maillants dérivants à gadiformes"
"GNDSHX"	"Filets maillants dérivants à squaliformes"
"GNEBSE"	"Filets maillants flottants à bars"
"GNSBSE"	"Filets maillants à bars"
"GNSGAD"	"Filets maillants à gadiformes"
"GNSSHX"	"Filets maillants à squaliformes"
"GNSSMX"	"Filets maillants à éperlans"
"GNSSRG"	"Filets maillants à sars"
"GTNBSE"	"Trémails et filets maillants à bars"
"GTRBSE"	"Trémails à bars"
"GTRGAD"	"Trémails à gadiformes"
"GTRJLX"	"Trémails à murex"
"GTRSHX"	"Trémails à squaliformes"
"LH_BSE"	"Lignes à main à bars"
"LH_GAD"	"Lignes à main à gadiformes"
"LHMBSE"	"Lignes à main et à cannes mécanisées à bars"
"LHPBSE"	"Lignes et cannes manuelles à bars"
"LHPGAD"	"Lignes et cannes manuelles à gadiformes"
"LL_BSE"	"Palangres diverses à bars"
"LLDBSE"	"Palangres dérivantes à bars"
"LLDGAD"	"Palangres dérivantes à gadiformes"
"LLDSHX"	"Palangres dérivantes à squaliformes"
"LLFBSE"	"Palangres flottantes à bars"
"LLSBSE"	"Palangres de fond à bars"
"LLSGAD"	"Palangres à gadiformes"
"LLSSHX"	"Palangres à squaliformes"
"LNBSMX"	"Filets soulevés d'un bateau à éperlans"
"LSPBSE"	"Lignes calées à bars"
"LTLBSE"	"Lignes de traîne à bars"
"LVDBSE"	"Palangres verticales dérivantes à bars"
"LVSBSE"	"Palangres verticales à bars"
"OFGCLX"	"Engins dormants à bivalves (divers)"
"OFGSLZ"	"Engins dormants à salmonidés (saumons, truites)"
"OTBBSE"	"Chaluts de fond à bars"
"OTBGAD"	"Chaluts de fond à gadiformes"
"OTBSHX"	"Chaluts de fond à squaliformes"
"OTBSMX"	"Chaluts de fond à éperlans"
"OTGSLZ"	"Engins traînants à salmonidés (saumons, truites)"
"OTMBSE"	"Chaluts pélagiques à bars"
"OTMGAD"	"Chaluts pélagiques à gadiformes"
"OTTGAD"	"Chaluts jumeaux à gadiformes"
"PREBSE"	"Charter de pêche de loisir à bars"
"PS_BSE"	"Sennes coulissantes à bars"
"PTBBSE"	"Chaluts boeufs de fond à bars"
"PTBGAD"	"Chaluts boeufs de fond à gadiformes"
"PTMBSE"	"Chaluts boeufs pélagiques à bars"
"SB_JLX"	"Sennes de plage à murex"
"SB_MUM"	"Sennes de plage à rougets"
"SDVCOL"	"Plongée à corail rouge"
"SDVMYV"	"Plongée à moules"
"SDVSJA"	"Plongée à coquille St-Jacques de Méditerranée"
"SDVURX"	"Plongée à oursins"
"TBBGAD"	"Chaluts à perche à gadiformes"
"SDNCTL"	"Sennes danoises à seiches"
"OTBOCT"	"Chaluts de fond à poulpes"
"FPONSQ"	"Casiers à nasse ceinturée"
"AUTFRE"	"Transport de fret"
"GNEBZX"	"Filets maillants flottants à bonites"
"GNCSPF"	"Filets maillants encerclants à petits pélagiques"
"LLSHAL"	"Palangres à flétan"
"OTBRJR"	"Chaluts de fond à raie radiée"
"FWRELE"	"Barrages, Parcs, Bordigues à anguille"
"FWRBSE"	"Barrages, Parcs, Bordigues à bars"
"GNSAMB"	"Filets maillants à sériole couronnée"
"PS_SSB"	"Sennes coulissantes à marbré"
"GTRRSE"	"Trémails à rascasse rouge"
"GTRYFX"	"Trémails à soupe (crénilabres)"
"GTRJOD"	"Trémails à Saint-Pierre"
"GNSDEC"	"Filets maillants à denté"
"GNSSBR"	"Filets maillants à dorade rose"
"FYKSBG"	"Verveux à dorade royale"
"OTMSBG"	"Chaluts pélagiques à dorade royale"
"SB_SIL"	"Sennes de plage à athérines"
"LLSBAI"	"Palangres à poissons batoïdes"
"TMOMZZ"	"Grands ganguis à panneaux à poissons"
"LVDMZZ"	"Palangres verticales dérivantes à poissons"
"MHIKUI"	"Pêche à pied à troque"
"FPOJSP"	"Casiers à langouste de St Paul"
"LLDSKH"	"Palangres dérivantes à requins"
"LTLSKH"	"Lignes de traîne à requins"
"LHPSKH"	"Lignes et cannes manuelles à requins"
"SDVCUX"	"Plongée à holoturies"
"PTBPOK"	"Chaluts boeufs de fond à lieu noir"
"LTLALB"	"Lignes de traîne à thon germon"
"LTLGAD"	"Lignes de traîne à à gadiformes"
"TMSURX"	"Petits ganguis à cadre à oursins"
"TMSMZZ"	"Petits ganguis à perche à poissons"
"GTRNEP"	"Trémails à langoustine"
"FYKSIL"	"Verveux à athérines"
"FDVOCT"	"Apnée à poulpes"
"SDVWOR"	"Plongée à vers marins"
"LLFSWO"	"Palangres flottantes à espadons"
"LVDSKH"	"Palangres verticales dérivantes à requins"
"PTB_DW"	"Chaluts boeufs de fond à poissons de grands fonds"
"LLSSKH"	"Palangres à requins"
"GTRSKH"	"Trémails à requins"
"SSCSQU"	"Sennes écossaises à calmars, encornets"
"SSCMZZ"	"Sennes écossaises à poissons"
"SSCBSE"	"Sennes écossaises à bars"
"SSCMUM"	"Sennes écossaises à rougets"
"GNSSPF"	"Filets maillants à petits pélagiques"
"PTTPOK"	"Chaluts jumeaux b½ufs de fond à lieu noir"
"OTPMZZ"	"Chaluts de fond multiples à poissons"
"OTPNEP"	"Chaluts de fond multiples à langoustine"
"OTBRED"	"Chaluts de fond à sébastes"
"OTBGHL"	"Chaluts de fond à flétan noir"
"LHPBRB"	"Lignes et cannes manuelles à dorade grise"
"OTTOCT"	"Chaluts jumeaux à panneaux à poulpes, pieuvres, élédones (divers)"
"GTRAPA"	"Trémail à appâts"
"OTPMNZ"	"Chaluts de fond multiples à baudroies"
