"METIER_DCF_5_COD"	"METIER_DCF_5_LIB"
"GNS_LPF"	"Filets maillants calés - Grands pélagiques"
"SDN_DEF"	"Sennes danoises - Poissons démersaux"
"DIV_SWD"	"Plongée - Algues"
"GTR_DEF"	"Trémails - Poissons démersaux"
"OTT_DWS"	"Chaluts de fond jumeaux à panneaux - Espèces profondes"
"FPO_CAT"	"Nasses et pièges - Poissons catadromes"
"LHP_FIF"	"Lignes à main et lignes à cannes - Poissons à nageoires"
"OTB_MOL"	"Chaluts de fond à panneaux - Mollusques"
"MIS_MOL"	"Divers - Mollusques"
"SB_FIF"	"Sennes de plage - Poissons à nageoires"
"PS_LPF"	"Sennes coulissantes - Grands pélagiques"
"DRB_CRU"	"Dragues - Crustacés"
"REC_LPF"	"Pêche récréative - Grands pélagiques"
"DIV_DEF"	"Plongée - Poissons démersaux"
"FOO_CEP"	"Pêche à pied - Céphalopodes"
"GNS_ANA"	"Filets maillants calés - Poissons anadromes"
"SSC_CEP"	"Sennes écossaises à calmars, encornets"
"LLD_SPF"	"Palangres dérivantes - Petits pélagiques"
"OTB_CRU"	"Chaluts de fond à panneaux - Crustacés"
"OTB_SPF"	"Chaluts de fond à panneaux - Petits pélagiques"
"PTB_CRU"	"Chaluts-b½ufs de fond - Crustacés"
"OTM_DEF"	"Chaluts pélagiques à panneaux - Poissons démersaux"
"LHP_LPF"	"Lignes à main et lignes à cannes - Grands pélagiques"
"MIS_SWD"	"Divers - Algues"
"FOO_DES"	"Pêche à pied - Espèces démersales"
"GTR_CEP"	"Trémails - Céphalopodes"
"SV_FIF"	"Sennes de bateaux - Poissons à nageoires"
"SDN_CEP"	"Sennes danoises - Céphalopodes"
"OTH_EEL"	"Autres engins - Civelle"
"REC_DEF"	"Pêche récréative - Poissons démersaux"
"DIV_LPF"	"Plongée - Grands pélagiques"
"SV_SPF"	"Sennes de bateaux - Petits pélagiques"
"GNC_DEF"	"Filets maillants encerclants - Poissons démersaux"
"DRB_SWD"	"Dragues - Algues"
"PTB_CEP"	"Chaluts-b½ufs de fond - Céphalopodes"
"OTM_CEP"	"Chaluts pélagiques à panneaux - Céphalopodes"
"FWR_DEF"	"Barrages, parcs, bordigues, etc - Poissons démersaux"
"INA"	"Inactifs"
"GND_CAT"	"Filets maillants dérivants - Poissons catadromes"
"LLS_DWS"	"Palangres calées - Espèces profondes"
"DRB_DES"	"Dragues - Espèces démersales"
"LN_CRU"	"Filets soulevés - Crustacés"
"LX_LPF"	"Hameçons et lignes - Grands pélagiques"
"GTR_CRU"	"Trémails - Crustacés"
"FYK_DEF"	"Verveux - Poissons démersaux"
"TBB_MOL"	"Chaluts à perche - Mollusques"
"GTN_LPF"	"Trémails et filets maillants combinés - Grands pélagiques"
"OTM_CAT"	"Chaluts pélagiques à panneaux - Poissons catadromes"
"OTT_CEP"	"Chaluts de fond jumeaux à panneaux - Céphalopodes"
"DIV_CEP"	"Plongée - Céphalopodes"
"FOO_CRU"	"Pêche à pied - Crustacés"
"GND_ANA"	"Filets maillants dérivants - Poissons anadromes"
"SPR_DEF"	"Sennes manoeuvrées par deux bateaux - Poissons démersaux"
"FYK_CAT"	"Verveux - Poissons catadromes"
"LLD_LPF"	"Palangres dérivantes - Grands pélagiques"
"FPO_CRU"	"Nasses et pièges - Crustacés"
"LTL_LPF"	"Lignes de traîne - Grands pélagiques"
"OTB_DEF"	"Chaluts de fond à panneaux - Poissons démersaux"
"PTM_DEF"	"Chaluts-b½ufs pélagiques - Poissons démersaux"
"DRB_MOL"	"Dragues - Mollusques"
"GNS_DEF"	"Filets maillants calés - Poissons démersaux"
"GNS_SPF"	"Filets maillants calés - Petits pélagiques"
"OTT_CRU"	"Chaluts de fond jumeaux à panneaux - Crustacés"
"LHM_LPF"	"Lignes à main et lignes avec cannes mécanisées - Grands pélagiques"
"LHM_MOL"	"Lignes à main et lignes à cannes mécanisées - Mollusques"
"MIS_DEF"	"Miscellaneous - Demersal fish"
"REC_MIS"	"Pêche récréative - Autres espèces"
"DIV_CRU"	"Plongée - Crustacés"
"SB_SPF"	"Sennes de plage - Petits pélagiques"
"GNS_CEP"	"Filets maillants calés - Céphalopodes"
"FPO_ANA"	"Nasses et pièges - Poissons anadromes"
"GTR_ANA"	"Trémails - Poissons anadromes"
"FPO_FIF"	"Nasses et pièges - Poissons à nageoires"
"GNS_CRU"	"Filets maillants calés - Crustacés"
"OTM_LPF"	"Chaluts pélagiques à panneaux - Grands pélagiques"
"PS_DEF"	"Sennes coulissantes - Poissons démersaux"
"LLD_DEF"	"Palangres dérivantes - Poissons démersaux"
"GTR_CAT"	"Trémails - Poissons catadromes"
"LLS_LPF"	"Palangres calées - Grands pélagiques"
"MIS_CAT"	"Divers - Poissons catadromes"
"MIS_MIS"	"Divers - Autres espèces"
"GTN_DEF"	"Trémails et filets maillants combinés - Poissons démersaux"
"OTB_CEP"	"Chaluts de fond à panneaux - Céphalopodes"
"REC_SPF"	"Pêche récréative - Petits pélagiques"
"LHP_SPF"	"Lignes à main et lignes à cannes - Petits pélagiques"
"OTB_ANA"	"Chaluts de fond à panneaux - Poissons anadromes"
"SSC_DEF"	"Sennes écossaises - Poissons démersaux"
"GND_DEF"	"Filets maillants dérivants - Poissons démersaux"
"PTM_LPF"	"Chaluts-b½ufs pélagiques - Grands pélagiques"
"MIS_DES"	"Divers - Espèces démersales"
"PTM_SPF"	"Chaluts-b½ufs pélagiques - Petits pélagiques"
"SB_MOL"	"Sennes de plage - Mollusques"
"LTL_SPF"	"Lignes de traîne - Petits pélagiques"
"PTB_DEF"	"Chaluts-b½ufs de fond - Poissons démersaux"
"DIV_DES"	"Plongée - Espèces démersales"
"TBB_CRU"	"Chaluts à perche - Crustacés"
"MIS_SPF"	"Divers - Petits pélagiques"
"FPO_CEP"	"Nasses et pièges - Céphalopodes"
"GNS_MOL"	"Filets maillants calés - Mollusques"
"FOO_MOL"	"Pêche à pied - Mollusques"
"GNS_DWS"	"Filets maillants calés - Espèces profondes"
"LNP_DEF"	"Filet soulevés portatifs- Poissons démersaux"
"SDN_SPF"	"Sennes danoises - Petits pélagiques"
"LA_SPF"	"Filets tournants sans coulisse (lamparo) - Petits pélagiques"
"OTT_DEF"	"Chaluts de fond jumeaux à panneaux - Poissons démersaux"
"OTT_MOL"	"Chaluts de fond jumeaux à panneaux - Mollusques"
"FPO_MOL"	"Nasses et pièges - Mollusques"
"GND_LPF"	"Filets maillants dérivants - Grands pélagiques"
"FCN_DEF"	"Filets-pièges fixes non couverts - Poissons démersaux"
"LHP_CEP"	"Lignes à main et lignes à cannes - Céphalopodes"
"OTB_CAT"	"Chaluts de fond à panneaux - Poissons catadromes"
"LN_CAT"	"Filets soulevés - Poissons catadromes"
"OTB_DWS"	"Chaluts de fond à panneaux - Espèces profondes"
"PTM_CEP"	"Chaluts-b½ufs pélagiques - Céphalopodes"
"FYK_CRU"	"Verveux - Crustacés"
"TBB_CEP"	"Chaluts à perche - Céphalopodes"
"PTB_DWS"	"Chaluts-b½ufs de fond - Espèces profondes"
"LLS_DEF"	"Palangres calées - Poissons démersaux"
"LN_DEF"	"Filets soulevés - Poissons démersaux"
"OTM_SPF"	"Chaluts pélagiques à panneaux - Petits pélagiques"
"OTHER"	"Autre activité que la pêche"
"DIV_MOL"	"Plongée - Mollusques"
"PS_SPF"	"Sennes coulissantes - Petits pélagiques"
"LN_SPF"	"Filets soulevés - Petits pélagiques"
"GNS_CAT"	"Filets maillants calés - Poissons catadromes"
"LLS_CAT"	"Palangres calées - Poissons catadromes"
"LTL_DEF"	"Lignes de traîne - Poissons démersaux"
"TBS_CRU"	"Chaluts à crevettes - Crustacés"
"GND_SPF"	"Filets maillants dérivants - Petits pélagiques"
"GTR_MOL"	"Trémails - Mollusques"
"LHM_FIF"	"Lignes à main et lignes à cannes mécanisées - Poissons à nageoires"
"TBB_DEF"	"Chaluts à perche - Poissons démersaux"
"FOO_SWD"	"Pêche à pied - Algues"
"GNC_SPF"	"Filets maillants encerclants - Petits pélagiques"
"LNP_SPF"	"Filet soulevés portatifs - Petits pélagiques"
